111111
1P0C01
100001
100001
1C0E01
111111
